NO /Users/abouzanb/Desktop/cub3d/textures/two.xpm
SO /Users/abouzanb/Desktop/cub3d/textures/brown.xpm
WE /Users/abouzanb/Desktop/cub3d/textures/lleagle.xpm
EA /Users/abouzanb/Desktop/cub3d/textures/groo.xpm
F 220,100,0
C 225,30,0

1111111111111111111111111
    100000000000000001
1111000000000000010101
10S0000000010010000101
10001010101010101010101
10000000000000000000001
10000000000000000000001
10000000000000000000001
10000000000000000000001
10101010101010101010101
1001010101010101010101
10000000000000000000001
1000000000000000000001
1111111111111111111111

