NO /Users/abouzanb/Desktop/cub3d/textures/two.xpm
SO /Users/abouzanb/Desktop/cub3d/textures/redbrick.xpm
WE /Users/abouzanb/Desktop/cub3d/textures/lleagle.xpm
EA /Users/abouzanb/Desktop/cub3d/textures/groo.xpm
F 220,100,0
C 225,30,0

1111111
10N10101
10001001
11111111