NO textures/text_no.xpm
SO textures/redbrick.xpm
WE textures/lleagle.xpm
EA textures/groo.xpm
F 220,100,0
C 225,30,0

1111111
10N10101
10000001
11111111