111111111111111
110000000000001
100000100000001
100001100000001
100000000000001
1000000N0000001
100010100100001
100000000000001
111111111111111