NO ./path_to_the_north_texture
SO ./path_to_the_south_texture
WE ./path_to_the_west_texture
EA ./path_to_the_east_texture
F 220,100,0
C 225,30,0

111111111111
1111111111111111111111111
1000000000000000000000001
1000000000000000000000001
10001000000N0000000100001
1000000000000000000000011
1000000000000001000000011
1000000000000001000000011
1000000000000001000000011
1000000000000001000000011
1000000000000001000000011
1000000000000001000000011
1000000000000001000000011
100000000000000100000001111
10000000000000010000000000011111
1000000000000001000000000001111111
1000000000000001000000000001111
1000000000000001000000000001111
1000000000000001000000000001111
1000000000000001000000000001111
1000000000000001000000000001111
1000000000000001000000000001111
1000000000000001000000000001111
100000000000000100000000000001111
100000000000000000000000000001111
111111111111111111111111111111111