NO /Users/abouzanb/Desktop/cub3d/textures/text_no.xpm
SO /Users/abouzanb/Desktop/cub3d/textures/one.xpm
WE /Users/abouzanb/Desktop/cub3d/textures/redbrick.xpm
EA /Users/abouzanb/Desktop/cub3d/textures/lleagle.xpm
F   223, 100, 109
C   135, 206, 235

111111111111111111111111111111111111
111111111111111111111111111111111111111111111111111111111111111111111111
101010101010101001010101010101001010101010101001010101010101011
101010101010101001010101010101001010101010101001010101010101011
1100000000000000000000000000000000000000000000000000000000000011111111111111111111111
1100000000000000000000000000000000000000000000000000000000000011111111111111111111111
1100000000000000000000000000000000000000000000000000000000000011111111111111111111111
1100000000000000000000000000000000000000000000000000000000000011111111111111111111111
1100000000000000000000000000000000000000000000000000000000000011111111111111111111111
1100000000000000000000000000000000000000000000000000000000000011111111111111111111111
1100000000000000000000000000000000000000000000000000000000000011111111111111111111111
1100000000000000000000000000000000000000000000000000000000000011111111111111111111111
1100000000000000000000000000000000000000000000000000000000000011111111111111111111111
1100000000000000000000000000000000000000000000000000000000000011111111111111111111111
1100000000000000000000000000000000000000000000000000000000000011111111111111111111111
1100000000000000000000000000000000000000000000000000000000000011111111111111111111111
1100000000000000000000000000000000000000000000000000000000000011111111111111111111111
1100000000000000000000000000000000000000000000000000000000000011111111111111111111111
1100000000000000000000000000000000000000000000000000000000000011111111111111111111111
1100000000000000000000000000000000000000000000000000000000000011111111111111111111111
1100000000000000000000000000000000000000000000000000000000000011111111111111111111111
1100000000000000000000000000000000000000000000000000000000000011111111111111111111111
1100000000000000000000000000000000000000000000000000000000000011111111111111111111111
1100000000000000000000000000000000000000000000000000000000000011111111111111111111111
1100000000000000000000000000000000000000000000000000000000000011111111111111111111111
1100000000000000000000000000000000000000000000000000000000000011111111111111111111111
101010101010100001010101010100001010101010100001010101010100011
101010101010101001010101010101001010101010101001010101010101011
100000000000001000000000000001000000000000001000000000000001011111111111111
111111111000110000000000000000111111111111111111111111111111111111111
1010000000N00000111111111111111
111111111111111111