NO /Users/abouzanb/Desktop/cub3d/textures/charaf-_1_.xpm
SO /Users/abouzanb/Desktop/cub3d/textures/anas-_1_.xpm
WE /Users/abouzanb/Desktop/cub3d/textures/o-_1_.xpm
EA /Users/abouzanb/Desktop/cub3d/textures/text-_1_.xpm
F 220,100,0
C 2205,30,0

111111
100101
101001
1100N1
111111